####################
#.#$.#.$#..........#
#....#.$#..........#
#....#.$#..........#
#....#..#..........#
#.......#..........#
#..######..........#
#..................#
#..................#
####################